.................................X...X..X........X
................X.X.XX...................X........
.........X.....X....X....................X...X....
....................................X..X..X...X...
.X......................X......X...........X.....X
..X.....X......X.................X.X..X...........
.X..........X......X...X......X.X......XX.XXXX....
..X....X....XX...............XX......X............
.......................X...........X.....X........
.......X....X......X.............X.............X..
......X..X........................................
.....................X.X......X...................
.........................X.X.X.............X..X...
.....X....................X..X....................
...........X.................X....................
............................X.......X.XXX.X.......
..............X...............................X...
..X......................XX.X..X...........X......
.............................X...................X
......................X............X..............
..X.XX............XX.....................XX....X..
.X..................X..........X...X.X............
....XX............................................
.......X.......X..............X...................
......................X...........X........X...X..
..................................................
..X.X........X.X..........X.........XX..X........X
..........X.........X....................X........
..................X..............X....X...........
...............X..X.....XX..X.....X..X............
...................X...X..........................
..........X.X....X.......X........................
.X.......X.....X................X........XX.......
......X....X.........X......X......XX.........X...
X..............X..................................
......X.......X...X...............X..............X
....X......X...X..................................
..........X....X.X.......X.....................X..
...........................................X......
..................................................
.........X............X..X..................X.....
...................X........................X.XXX.
.......X.......................X............X.....
......X.....X........X.X...X.X....X..X............
X.................X.......X...................X...
X.X..X............X.....X............X.X..X.......
...............X...X...X..............XXX.........
.X.......X.........X.............XX.....X.X......X
.....X...................X.................X......
...X...........X.X..X...X..........X...........X..
