1111111111111111
1S100G00100G0101
1011011010101101
1000010G001001G1
1101111100110001
100G01G0010G0011
1111010100011001
10G1000G01010011
1011111011000111
10G0000001110G01
1101110111011101
1000G001010G0101
1G00100G00010G01
1010111111011011
1G0G001000G00GE1
1111111111111111
